v ? |      < 
?      ?     
?   ?      |>
?      -     
>   ^  ?   < 
